1111111
1C00001
1110101
1C10101
1010101
1P001E1
1111111