111111111111111
1CCCCCCCC111C11
111C1C11CCC1C11
1C1C1CCC1C1CC11
1P1C1C111CCC111
10CC111111CCCE1
111111111111111