111111111111111
1C0000000111C11
11101C11CCC1C11
10101CCC1C1CC11
1P101C111CCC111
1000111111CCCE1
111111111111111
