1111111111111111111111
10000000000001C0001001
100E000111101101111011
1P10000001100000000001
1111111111111111111111